{
    "name": "overworld",
    "size": { "x": 20, "y": 10 },
    "layers": [
        {
            "tiles": [
                1 , 1 , 1 , 1 , 1 , 1 , 1 , 1 , 1 , 1 , 1 , 1 , 1 , 1 , 1 , 1 , 1 , 1 , 1 , 1 ,
                1 , 1 , 1 , 1 , 1 , 1 , 1 , 3 , 7 , 7 , 4 , 1 , 1 , 1 , 1 , 1 , 1 , 1 , 1 , 1 ,
                1 , 1 , 1 , 3 , 7 , 7 , 7 , 14, 15, 2 , 9 , 3 , 7 , 7 , 7 , 7 , 4 , 1 , 1 , 1 ,
                1 , 1 , 3 , 14, 2 , 2 , 19, 23, 23, 20, 13, 14, 2 , 15, 2 , 2 , 13, 4 , 1 , 1 ,
                1 , 3 , 14, 2 , 16, 2 , 24, 27, 28, 29, 20, 2 , 2 , 19, 20, 2 , 2 , 9 , 1 , 1 ,
                1 , 8 , 2 , 2 , 2 , 2 , 24, 29, 30, 32, 29, 20, 19, 30, 25, 2 , 15, 13, 4 , 1 ,
                1 , 5 , 12, 2 , 2 , 2 , 21, 26, 26, 26, 26, 22, 21, 26, 22, 2 , 2 , 11, 6 , 1 ,
                1 , 1 , 5 , 10, 12, 2 , 15, 2 , 2 , 2 , 2 , 2 , 16, 2 , 2 , 11, 10, 6 , 1 , 1 ,
                1 , 1 , 1 , 1 , 5 , 10, 10, 10, 10, 10, 10, 10, 10, 10, 10, 6 , 1 , 1 , 1 , 1 ,
                1 , 1 , 1 , 1 , 1 , 1 , 1 , 1 , 1 , 1 , 1 , 1 , 1 , 1 , 1 , 1 , 1 , 1 , 1 , 1 
            ]
        },
        {
            "tiles": [
                0 , 0 , 0 , 0 , 0 , 0 , 0 , 0 , 0 , 0 , 0 , 0 , 0 , 0 , 0 , 0 , 0 , 0 , 0 , 0 ,
                0 , 0 , 0 , 0 , 0 , 0 , 0 , 0 , 0 , 0 , 0 , 0 , 0 , 0 , 0 , 0 , 0 , 0 , 0 , 0 ,
                0 , 0 , 0 , 0 , 0 , 0 , 0 , 0 , 0 , 0 , 0 , 0 , 0 , 0 , 0 , 0 , 0 , 0 , 0 , 0 ,
                0 , 0 , 0 , 0 , 0 , 0 , 0 , 0 , 0 , 41, 0 , 0 , 0 , 0 , 0 , 0 , 0 , 0 , 0 , 0 ,
                0 , 0 , 0 , 0 , 0 , 40, 0 , 0 , 0 , 0 , 0 , 0 , 0 , 41, 0 , 0 , 0 , 35, 34, 34,
                0 , 0 , 0 , 0 , 0 , 0 , 0 , 0 , 0 , 0 , 0 , 0 , 0 , 0 , 0 , 0 , 0 , 0 , 0 , 0 ,
                0 , 0 , 0 , 0 , 0 , 0 , 0 , 41, 0 , 0 , 0 , 0 , 0 , 0 , 41, 0 , 0 , 0 , 0 , 0 ,
                0 , 0 , 0 , 0 , 0 , 0 , 0 , 0 , 0 , 0 , 0 , 0 , 0 , 0 , 0 , 0 , 0 , 0 , 0 , 0 ,
                0 , 0 , 0 , 0 , 0 , 0 , 0 , 0 , 0 , 0 , 0 , 0 , 0 , 0 , 0 , 0 , 0 , 0 , 0 , 0 ,
                0 , 0 , 0 , 0 , 0 , 0 , 0 , 0 , 0 , 0 , 0 , 0 , 0 , 0 , 0 , 0 , 0 , 0 , 0 , 0 
            ]
        }
    ],
    "tileset": "46a0eb22-ce63-48de-991c-a670298d4207"
}